wwwwwwwwwwwwwwwwwwwwwwwwwwwwwwwwwwwwwwwwwwwwwwww
w##############################################w
w##############################################w
w##############################################w
w##k#######################k###################w
w##############################################w
w##############################################w
w##############################################w
w##############################################w
w##############################################w
w##############################################w
w##############################################w
w##############################################w
w##############################################w
w###########k#######k###############k#######k##w
w##############################################w
w##############################################w
w##k#######################k###################w
w##############################################w
w##############################################w
w##############################################w
w##############################################w
w##############################################w
w##############################################w
w##############################################w
w##############################################w
w##############################################w
w###########k#######k###############k#######k##w
w##############################################w
wwwwwwwwwwwwwwwwwwwwwwwwwwwwwwwwwwwwwwwwwwwwwwww