wwwwwwwwwwwwwwwwwwwwwwwwwwwwwwwwwwwwwwwwwwwwwwww
w##############################################w
w##############################################w
w##############################################w
w##k#######################k###################w
w##############################################w
w#######h######################################w
w##############################################w
w##############################################w
w#################s############################w
w##############################################w
w##############################################w
w##############################################w
w############################h#################w
w###########k#######k###############k#######k##w
w##############################################w
w##############################################w
w##k#######################k###################w
w##############################################w
w##############################################w
w##############################################w
w#####BBBBBBBBBBB############s#################w
w##############################################w
w##############################################w
w##############################################w
w##############################################w
w##############################################w
w###########k#######k###############k#######k##w
w##############################################w
wwwwwwwwwwwwwwwwwwwwwwwwwwwwwwwwwwwwwwwwwwwwwwww