wwwwwwwwwwwwwwwwwwwwwwww
w#####B################w
w##c##B################w
w#####B################w
wBBBBBB################w
w######################w
w######################w
w#####p################d
w######################w
w######################w
w######################w
w######################w
w###############b###c##w
w######################w
wwwwwwwwwwwwwwwwwwwwwwww