wwwwwwwwwwwwwww
w#####B#######w
w##c##B#######w
w#####B#######w
wBBBBBB#######w
w#############w
w#############w
w#####p#######d
w#############w
w#############w
w#############w
w#############w
w#############w
w#############w
wwwwwwwwwwwwwww