wwwwwwwwwwwwwwwwwwwwwwwwwwwwwwwwwwwwwwwwwwwwwwww
w#####B################ww#####B################w
w##c##B################ww##c##B################w
w#####B################ww#####B################w
wBBBBBB################wwBBBBBB################w
w######################ww######################w
w######################ww######################w
w#####p################dw######################d
w######################ww######################w
w######################ww######################w
w######################ww######################w
w######################ww######################w
w###############b###c##ww###############b###c##w
w######################ww######################w
w##############################################w
w##############################################w
w#####B################ww#####B################w
w##c##B################ww##c##B################w
w#####B################ww#####B################w
wBBBBBB################wwBBBBBB################w
w######################ww######################w
w######################ww######################w
w######################dw######################d
w######################ww######################w
w######################ww######################w
w######################ww######################w
w######################ww######################w
w###############b###c##ww###############b###c##w
w######################ww######################w
wwwwwwwwwwwwwwwwwwwwwwwwwwwwwwwwwwwwwwwwwwwwwwww