wwwwwwwwwwwwwwwwwwwwwwww
w######################w
w##c###################w
w######################w
w######################w
w######################w
w######################w
d######################d
w######################w
w######################w
w######################w
w######################w
w###################c##w
w######################w
wwwwwwwwwwwwwwwwwwwwwwww
