wwwwwwwwwwwwwwwwwwwwwwww
w###############w######w
w##c#################w#w
w######################w
w######################w
w#################c####w
d######################w
w######################w
w######################w
w######################w
w######################w
w########c#############w
w###################c##w
w######################w
wwwwwwwwwwwwwwwwwwwwwwww
