wwwwwwwwwwwwwwwwwwwwwwww
w######################w
w##c##############w####w
w######################w
w######################w
w#################c####w
d######################d
w######################w
w######################w
w#######w##############w
w######################w
w######################w
w###################c##w
w######################w
wwwwwwwwwwwwwwwwwwwwwwww
